#######################
#..........#..........#
#.###.####=#.####.###.#
#o###.####.#.####.###o#
#.....................#
#.### #.#######.#.###.#
#.... #....#....#.....#
##### #### # ####.#####
#   # #         #.#   #
##### # ### ### #.#####
#       #     #  .    #
##### #=####### #.#####
#   # #    %    #.#   #
##### # ####### #.#####
#     .....#..........#
# ### ####.#.####.###.#
#   # ............#..o#
### # #.#######.#.#.###
#   ..#.. \#....#.....#
# ######## #.########.#
#          ...........#
#######################
